8 1 12 1 7 1 8 1 5 1 7 1 3 1 2 1 2 6
8 1 12 1 7 1 8 1 5 1 7 1 8 1 10 1 10 6
25 3 5 1 5 1 8 1 8 1 5 1 5 1 12 1 12 3 12 3 8 4 10 1 10 3 10 3 7 4 10 1 10 3 10 3 8 1 7 1 5 4
25 3 5 1 5 1 8 1 8 1 5 1 5 1 12 1 12 3 12 3 8 4 10 1 10 3 10 3 7 4 10 1 10 3 10 3 8 1 7 1 5 4
25 3 5 1 5 1 8 1 8 1 5 1 5 1 12 1 12 3 12 3 8 4 10 1 10 3 10 3 7 4 10 1 10 3 10 3 8 1 7 1 5 4
25 3 5 1 5 1 8 1 8 1 5 1 5 1 12 1 12 3 12 3 8 4 10 1 10 3 10 3 7 4 10 1 10 3 10 3 8 1 7 1 5 4
5 4 5 1 8 1 8 1 12 1 12 1 14 1 10 4 14 1 14 1 10 1 10 1
5 4 5 1 8 1 8 1 12 1 12 1 14 1 10 4 14 1 14 1 10 1 10 1
5 4 5 1 8 1 8 1 12 1 12 1 14 1 10 4 14 1 14 1 10 1 10 1
5 4 5 1 8 1 8 1 12 1 12 1 14 1 10 4 14 1 14 1 10 1 10 1
25 3 5 1 5 1 8 1 8 1 5 1 5 1 12 1 12 3 12 3 8 4 10 1 10 3 10 3 7 4 10 1 10 3 10 3 8 1 7 1 5 4
25 3 5 1 5 1 8 1 8 1 5 1 5 1 12 1 12 3 12 3 8 4 10 1 10 3 10 3 7 4 10 1 10 3 10 3 8 1 7 1 5 4
25 3 5 1 5 1 8 1 8 1 5 1 5 1 12 1 12 3 12 3 8 4 10 1 10 3 10 3 7 4 10 1 10 3 10 3 8 1 7 1 5 4
25 3 5 1 5 1 8 1 8 1 5 1 5 1 12 1 12 3 12 3 8 4 10 1 10 3 10 3 7 4 10 1 10 3 10 3 8 1 7 1 5 4
5 4 5 1 8 1 8 1 12 1 12 1 14 1 10 4 14 1 14 1 10 1 10 1
5 4 5 1 8 1 8 1 12 1 12 1 14 1 10 4 14 1 14 1 10 1 10 1
5 4 5 1 8 1 8 1 12 1 12 1 14 1 10 4 14 1 14 1 10 1 10 1
5 4 5 1 8 1 8 1 12 1 12 1 14 1 10 4 14 1 14 1 10 1 10 1