18 3 16 1 19 3 18 1 14 1 9 7 
6 3 4 1 7 3 6 1 2 1 6 5 4 5 
16 3 15 1 18 3 16 1 13 1 16 3 14 3 13 3 14 3 11 1 13 3 16 3 14 3 9 1 9 7
18 3 16 1 19 3 18 1 14 1 9 7 
6 3 4 1 7 3 6 1 2 1 6 5 4 5 
16 3 15 1 18 3 16 1 13 1 16 3 14 3 13 3 14 3 11 1 13 3 16 3 14 3 18 1 18 7 
6 1 7 3 11 3 9 7 9 4 6 1 7 3 11 3 9 1 4 3 7 3 6 1 25 1 6 1 
6 5 6 8 7 8 9 8 12 3 11 3 9 4 2 1 12 3 11 3 9 4 2 1 6 1 4 3 2 4 2 3
4 4 6 1 7 3 11 3 9 7 9 4 6 1 7 3 11 3 9 1 4 3 7 3 6 1 25 1 6 1  
6 5 6 8 7 8 9 8 12 3 11 3 9 4 2 1 12 3 11 3 9 4 2 1 6 3 4 3 2 3 4 3 7 3 6 3 2 3 1 3 2 7
18 3 16 1 19 3 18 1 14 1 9 7 
6 3 4 1 7 3 6 1 2 1 6 5 4 5 
16 3 15 1 18 3 16 1 13 1 16 3 14 3 13 3 14 3 11 1 13 3 16 3 14 3 9 1 9 7
18 3 16 1 19 3 18 1 14 1 9 7 
6 3 4 1 7 3 6 1 2 1 6 5 4 5 
16 3 15 1 18 3 16 1 13 1 16 3 14 3 13 3 14 3 11 1 13 3 16 3 14 3 18 1 18 7 
6 1 7 3 11 3 9 7 9 4 6 1 7 3 11 3 9 1 4 3 7 3 6 1 25 1 6 1 
6 5 6 8 7 8 9 8 12 3 11 3 9 4 2 1 12 3 11 3 9 4 2 1 6 1 4 3 2 4 2 3
4 4 6 1 7 3 11 3 9 7 9 4 6 1 7 3 11 3 9 1 4 3 7 3 6 1 25 1 6 1  
6 5 6 8 7 8 9 8 12 3 11 3 9 4 2 1 12 3 11 3 9 4 2 1 6 3 4 3 2 3 4 3 7 3 6 3 2 3 1 3 2 7